1111111111111111111111111111111111111111111111111111111111111111
1       b b b b b b b b b      b1         b b b b b b b b      1
1 1111 1  1 1111 1  1     2    b1 1111 1  1 1111 1  1          1
1 1    1  1 1    1 1      2       1    1  1 1    1 1           1
1 1111 1  1 1    11       2    11 1111 1  1 1    11       2    1
1 1    1  1 1    1 1           11 1    1  1 1    1 1           1
1 1    1111 1111 1  1   111111111 1    1111 1111 1  1   11111111
1        b b b b b b b b b     11      b b b b b b b b b       1
1   2 2 2 22  2  2  2 1        11                     1        1
1       b b b b b b b b b      11    b b b b b b b b b         1
1             1                11             1                1
1      b b b b b b b b b       11    b b b b b b b b b         1
1       1 1 1 1 1 1 1     1111 11       1 1 1 1 1 1 1     1111 1
1      b b b b b b b b b             b b b b b b b b b         1
111111122222222222111222111111  12111111222111222111122211122211
111222222222111111122222221111    111111111111111111111111111111
1                              11                              1
1 1111 1  1 1111 1  1          11 1111 1  1 1111 1  1          1
1 1    1  1 1    1 1           11 1    1  1 1    1 1           1
1 1111 1  1 1    11            11 1111 1  1 1    11            1
1 1    1  1 1    1 1           22 1    1  1 1    1 1           1
1 1    1111 1111 1  1   111112221 1    1111 1111 1  1   11111111
1                              22                              1
1                     1        11                     1        1
1                              11                              1111
1             1                11             1                   1
1                              11                              1  1
1       1 1 1 1 1 1 1     1111 11       1 1 1 1 1 1 1     1111 1  1
1                                                              1  1
1111111111112222221111111111111111111111111111111111111111111111  1
1111222222222111111112222211111111111111111111111111111111111111  1
1                              11                              1  1
1 1111 1  1 1111 1  1          11 1111 1  1 1111 1  1          1  1
1 1    1  1 1    1 1           11 1    1  1 1    1 1           1  1
1 1111 1  1 1    11            11 1111 1  1 1    11               1
1 1    1  1 1    1 1           11 1    1  1 1    1 1           1111
1 1    1111 1111 1  1   111111111 1    1111 1111 1  1   11111111
1                              11                              1
1                     1        11                     1        1
1                              11                              1
1             1                11             1                1
1                              11                              1
1       1 1 1 1 1 1 1     1111 11       1 1 1 1 1 1 1     1111 1
1                                                              1
1112111112222211111111111111111  1111111111111111111111111111111
111222211111122222221111111111    111111111111111111111111111111
1                              11                              1
1 1111 1  1 1111 1  1          11 1111 1  1 1111 1  1          1
1 1    1  1 1    1 1           11 1    1  1 1    1 1           1
1 1111 1  1 1    11            11 1111 1  1 1    11            1
1 1    1  1 1    1 1           11 1    1  1 1    1 1           1
1 1    1111 1111 1  1   111111111 1    1111 1111 1  1   11111111
1                              11                              1
1                     1        11                     1        1
1                              11                              1
1             1                11             1                1
1                              11                              1
1       1 1 1 1 1 1 1     1111 11       1 1 1 1 1 1 1     1111 1
1                                                              1
1111111111111111111111111111111111111111111111111111111111111111